# # # I # #
S A U C E #
# I # E # #
# M # # L #
# # F R O G
# # # # O #
# # # # P # 