# M O U S E # # # #
# # # # A # # # # #
# # # # M O O S E #
H O U S E # # # E #
# # # # # # T A L L